11111111111111
1P0100100C1111
10000111011111
1000C111001111
100000000000E1
11111111111111
