11111111111111
1P010000E01111
10000111001111
1000C111001111
11111111111111
11111111111111