11111111111
1P000000001
1000CCC0001
100000000E1
11111111111