11111111111111
1P0100111C1111
10000111001111
1000C111011111
100000000000E1
11111111111111










