11111111111111
1P010010001111
10000111111111
1000C111001111
100000000000E1
11111111111111