1111111111111
1P01000000001
1000011111001
1100110000111
1100C000000E1
1111111111111